DEFINE
0 VOID
1 TREE
2 APPLE
10 GOLDEN_APPLE
3 SWORD
4 AXE
5 BRICK
6 GRASS
7 ZOMBIE
8 BOSS
9 HEARTH
11 DIRT
END DEFINE
SECTIONS
SECTION 0 -1 6
1 1 1 1 1 0 1 1 1 1 1 
1 0 0 0 0 0 0 0 0 0 1 
1 0 0 0 0 0 0 0 0 0 1 
1 0 0 0 0 0 0 0 0 0 1 
1 0 0 0 0 0 0 0 0 0 1 
1 4 0 0 0 0 0 0 0 0 1 
1 1 1 1 1 1 1 1 1 1 1 
END SECTION
SECTION 0 0 6
1 1 1 1 1 1 1 1 1 1 1 
1 0 0 0 0 0 0 2 0 0 1 
1 0 0 0 0 0 0 0 0 0 1 
1 0 0 0 0 0 0 0 0 0 0 
1 0 0 0 0 0 0 0 0 0 1 
1 0 0 0 0 0 0 0 0 0 1 
1 1 1 1 1 0 1 1 1 1 1 
END SECTION
SECTION 1 0 6
1 1 1 1 1 1 1 1 1 1 1 
1 0 0 0 0 0 0 0 0 0 0 
1 0 0 0 0 0 0 0 0 0 1 
0 0 0 0 0 0 0 0 0 0 1 
1 0 0 0 0 0 0 0 0 0 1 
1 0 0 2 0 0 0 0 0 0 0 
1 1 1 1 1 1 1 1 1 1 1 
END SECTION
SECTION 2 -1 6
1 1 1 1 1 0 1 1 1 1 1 
1 0 0 0 0 0 0 0 0 0 1 
1 0 0 0 0 0 0 0 0 0 1 
1 0 0 0 0 0 0 0 0 0 0 
1 0 0 0 0 0 0 0 0 0 1 
1 9 0 0 0 0 0 0 0 0 1 
1 1 1 1 1 1 1 1 1 1 1 
END SECTION
SECTION 2 0 6
1 1 1 1 1 1 1 5 0 5 1 
0 0 0 0 0 0 1 0 0 0 1 
1 0 0 0 0 3 1 0 0 0 1 
1 1 1 1 1 1 1 0 0 0 0 
1 0 0 0 0 0 1 0 0 0 1 
0 0 0 0 0 0 1 9 0 0 1 
1 1 1 1 1 0 1 1 1 1 1 
END SECTION
SECTION 2 1 11
5 5 5 5 5 5 5 5 5 5 5 
5 10 0 0 0 0 0 0 0 0 5 
5 5 5 5 5 5 5 0 0 0 5 
5 0 0 0 0 0 0 0 0 0 5 
5 0 0 5 5 5 5 5 5 5 5 
5 0 0 0 0 0 0 0 0 0 5 
5 5 5 5 5 5 5 5 0 5 5 
END SECTION
SECTION 3 -1 6
1 1 1 1 1 0 1 1 1 1 1 
1 0 0 0 0 0 0 0 0 0 1 
1 0 0 0 0 0 0 0 0 0 1 
0 0 0 0 0 9 0 0 0 0 1 
1 0 0 0 0 0 0 0 0 0 1 
1 0 0 0 0 0 0 0 0 0 1 
1 1 1 1 1 1 1 1 1 1 1 
END SECTION
SECTION 3 0 6
1 1 1 1 1 1 1 1 1 1 1 
1 0 0 0 0 0 0 0 0 9 1 
1 0 0 0 0 0 0 0 0 0 1 
0 0 0 0 0 0 0 0 0 0 1 
1 0 0 0 0 0 0 0 0 0 1 
1 0 0 0 0 0 0 0 0 0 1 
1 1 1 1 1 0 1 1 1 1 1 
END SECTION
END SECTIONS
DEFAULT_SECTION
SET 2 1
END DEFAULT_SECTION
PLAYER
SET 2 1
END PLAYER
MONSTERS
ADD 8 3 0 0 7
ADD 4 2 1 0 7
ADD 4 2 2 -1 7
ADD 3 2 2 0 7
ADD 7 2 2 0 7
ADD 3 1 2 1 8
END MONSTERS
